char **maze = {
"   |||||||||||||||||||||||||||||||||||||||||||",
"   |  |        |        |        |  |        |",
"|  |  |  |||||||  |||||||  |||||||  ||||  |  |",
"|     |                 |  |     |     |  |  |",
"||||  ||||  |  ||||||||||  |  |  ||||  |  ||||",
"|        |  |  |     |  |     |     |        |",
"|||||||  |  ||||  |  |  ||||  |||||||||||||  |",
"|           |     |        |                 |",
"|||||||  ||||  |||||||  ||||  ||||  |  ||||  |",
"|  |  |        |  |           |     |  |     |",
"|  |  ||||  ||||  |||||||  |||||||||||||  ||||",
"|        |     |        |           |        |",
"||||  |||||||  |  |  |  |||||||||||||  |  |  |",
"|        |  |  |  |  |  |           |  |  |  |",
"|||||||  |  |  |  ||||||||||  ||||||||||  |  |",
"|  |  |           |                       |  |",
"|  |  |  |  |  |||||||  |  ||||  |||||||  |  |",
"|        |  |        |  |  |  |  |        |  |",
"||||  ||||  |||||||  |||||||  |||||||  |||||||",
"|     |     |        |           |     |     |",
"|  |||||||||||||  |  ||||  ||||  |  ||||  ||||",
"|     |           |     |  |     |           |",
"|  ||||||||||  |||||||||||||  |||||||  |||||||",
"|     |  |     |  |  |  |  |     |     |     |",
"|  ||||  ||||  |  |  |  |  |  |  |  ||||  |  |",
"|     |              |  |     |           |  |",
"|||||||  |  |  |||||||  |||||||||||||||||||  |",
"|     |  |  |     |     |     |           |  |",
"|  |  |  |  ||||  |  |  |  ||||  |  ||||  ||||",
"|  |     |  |        |           |     |      ",
"|||||||||||||||||||||||||||||||||||||||||||   "
};
